Bambou	Bois > Bambou
Bois	Bois
Bois Acajou	Bois > Acajou
Bois Amarante	Bois > Amarante
Bois Amboine	Bois > Amboine
Bois blanc	Bois > Blanc
Bois Bouleau	Bois > Bouleau
Bois Cerisier	Bois > Cerisier
Bois Châtaignier	Bois > Châtaignier
Bois Chêne	Bois > Chêne
Bois Citronnier	Bois > Citronnier
Bois Contreplaqué	Bois > Contreplaqué
Bois de Rose	Bois > Rose
Bois de Violette	Bois > Violette
Bois doré	Bois > Doré
Bois Ebène	Bois > Ebène
Bois Erable	Bois > Erable
Bois Frêne	Bois > Frêne
Bois Gaïac	Bois > Gaïac
Bois Hêtre	Bois > Hêtre
Bois If	Bois > If
Bois Isorel	Bois > Isorel
Bois Louro Faia	Bois > Louro Faia
Bois Louro Preto	Bois > Louro Preto
Bois Marqueterie	Bois > Marqueterie
Bois Médium	Bois > Médium
Bois Merisier	Bois > Merisier
Bois noir	Bois > Noir
Bois Noyer	Bois > Noyer
Bois Orme	Bois > Orme
Bois Palissandre	Bois > Palissandre
Bois peint	Bois > Peint
Bois Pin	Bois > Pin
Bois Platane	Bois > Platane
Bois Poirier	Bois > Poirier
Bois Satine	Bois > Satine
Bois Stratifié / Lamifié / Formica	Bois > Stratifié / Lamifié / Formica
Bois Sycomore	Bois > Sycomore
Bois Teck	Bois > Teck
Bois Wengé	Bois > Wengé
Céramique	Céramique
Céramique Biscuit	Céramique > Biscuit
Céramique Biscuit de Sèvres	Céramique > Biscuit > de Sèvres
Céramique Faïence	Céramique > Faïence
Céramique Grès	Céramique > Grès
Céramique Grès de Sèvres	Céramique > Grès > de Sèvres
Céramique Porcelaine	Céramique > Porcelaine
Céramique Porcelaine d'Asie	Céramique > Porcelaine > d'Asie
Céramique Porcelaine de Sèvres	Céramique > Porcelaine > de Sèvres
Céramique Terre cuite	Céramique > Terre cuite
Composite Béton	
Composite Fibre de Carbone	
Coquillage	
Corian	
Dessin Aquarelle	
Dessin Craie blanche	
Dessin Crayon	
Dessin Fusain	
Dessin Gouache	
Dessin Mine de plomb	
Dessin Pastel	
Dessin Sanguine	
Email	
Ivoire	
Laque	Laque
Lithographie	
Métal	Métal
Métal Acier	Métal > Acier
Métal Aluminium	Métal > Aluminium
Métal Argenté	Métal > Précieux > Argent
Métal Bronze	Métal > Bronze
Métal Cuivre	Métal > Cuivre
Métal Doré	Bois > Doré
Métal Etain	Métal > Étain
Métal Fer	Métal > Fer
Métal Fer forgé	Métal > Fer forgé
Métal Fonte	Métal > Fonte
Métal Graphite	Métal > Graphite
Métal Inox	Métal > Inox
Métal Laiton	Métal > Laiton
Métal laqué	Métal > Laqué
Métal précieux	Métal > Précieux
Métal précieux Argent	Métal > Précieux > Argent
Métal précieux Vermeil	Métal > Précieux > Vermeil
Métal Tôle peinte	Métal > Tôle peinte
Peau	
Peau Cheval	
Peau Cuir	Cuir
Peau Galuchat	
Peinture Acrylique	
Peinture Huile	
Photographie	
Pierre	Pierre
Pierre Albâtre	Pierre > Albâtre
Pierre Granit	Pierre > Granit
Pierre Malachite	Pierre > Malachite
Pierre Marbre	Pierre > Marbre
Pierre Onyx	Pierre > Onyx
Pierre Opaline	Pierre > Opaline
Pierre Porphyre	Pierre > Porphyre
Plastique Altuglas	Plastique > Altuglas
Plastique Plexiglas	Plastique > Plexiglas
Plastique Polycarbonate	Plastique > Polycarbonate
Plastique Polyester	Plastique > Polyester
Plastique Polypropylène	Plastique > Polypropylène
Plastique Résine	Plastique > Résine
Plâtre / Stuc / Staff	Plâtre et stuc
Rotin	Bois > Rotin
Textile Coton	Textile > Coton
Textile Fil d'Argent	Textile > Fils d’or et d’argent
Textile Fil d'Or	Textile > Fils d’or et d’argent
Textile Laine	Textile > Laine
Textile Lin	Textile > Lin
Textile Soie	Textile > Soie
Verre	Verre
Verre blanc	Verre > Blanc
Verre Cristal	Verre > Cristal
Verre de Venise	Verre > de Venise